/--------------\
[..............]
[..............]
[..............]
[..............]
[..............]
[..............]
[..............]
[..............]
[..............]
[..............]
[..............]
[..............]
[..............]
[..............]
<==============>